15
15
RRRRRRRRRRRRRRR
REREEEEEEEEEEER
RERERRRRRRRRRER
REREREEEEEEERER
RERERERRRRRERER
REREREREEERERER
RERERERERERERER
RERERERARERERER
RERERERRRERERER
REREREEEEERERER
RERERRRRRRRERER
REREEEEEEEEERER
RERRRRRRRRRRRER
REEEEEEEEEEEEER
RRRRRRRRRRRRRRR